RRBRRREBREREBREREBRE
BREBRBREBRBREBRBREBR
REBREREBREREBREREBRE
BREBRBREBRBREBRBREBR
REBREREBREREBREREBRE
BRBBRBRBBRBRBBRBRBBR
REBREREBREREBREREBRE
BREBRBREBRBREBRBREBR
REBRERRBRRRRBRRRRBRR
BRRBRBRRBRBRRBRBRRBR
RRBRRRRBRRRRBRRRRBRE
BREBRBREBRBREBRBREBR
REBREREBREREBREREBRE
BREBRBRBBRBRBBRBRBBR
RBBRBRBBRBRBBRBRBBRB
BRBBRBRBBRBRBBRBRBBR
RBBRBRBBRBRBBREREBRE
BREBRBREBRBREBRBREBR
REBREREBRERRBRRRRBRR
BREBRBREBRBREBRBREBR
